ARE	AA R
ARE(2)	ER
FROBO	F R OW B AO
GO	G OW
HALL	HH AO L
HALT	HH AO L T
IS	IH Z
KITCHEN	K IH CH AH N
LIVING	L IH V IH NG
NO	N OW
STOP	S T AA P
THE	DH AH
THE(2)	DH IY
TIME	T AY M
TO	T UW
TO(2)	T IH
TO(3)	T AH
WHAT	W AH T
WHAT(2)	HH W AH T
WHO	HH UW
YES	Y EH S
YOU	Y UW
